11111
1P0C1
1C001
10001
11111
