11111
1P00C
10001
1C00E
11110
