11111
1PP0C
100E1
1C001
11111
