111111111
1P00000C1
100111001
1C00000E1
111111111
