11111111
1P0000C1
10001101
100C00E1
11111111
