1111111111
1P0000C001
1001111001
1C000000E1
1111111111
